"filename", "language", "Markdown", "JSON", "Python", "comment", "blank", "total"
"/home/manodeep/projects/iit_bhilai_2025/llm_security/rep/EXPLOIT AGENT.ipynb", "JSON", 0, 892, 0, 0, 0, 892
"/home/manodeep/projects/iit_bhilai_2025/llm_security/rep/README.md", "Markdown", 1, 0, 0, 0, 0, 1
"/home/manodeep/projects/iit_bhilai_2025/llm_security/rep/html_files/app.py", "Python", 0, 0, 92, 7, 25, 124
"/home/manodeep/projects/iit_bhilai_2025/llm_security/rep/models/models--Salesforce--blip-image-captioning-base/.no_exist/82a37760796d32b1411fe092ab5d4e227313294b/adapter_config.json", "JSON", 0, 0, 0, 0, 1, 1
"/home/manodeep/projects/iit_bhilai_2025/llm_security/rep/models/models--Salesforce--blip-image-captioning-base/.no_exist/82a37760796d32b1411fe092ab5d4e227313294b/added_tokens.json", "JSON", 0, 0, 0, 0, 1, 1
"/home/manodeep/projects/iit_bhilai_2025/llm_security/rep/models/models--Salesforce--blip-image-captioning-base/.no_exist/82a37760796d32b1411fe092ab5d4e227313294b/chat_template.json", "JSON", 0, 0, 0, 0, 1, 1
"/home/manodeep/projects/iit_bhilai_2025/llm_security/rep/models/models--Salesforce--blip-image-captioning-base/.no_exist/82a37760796d32b1411fe092ab5d4e227313294b/generation_config.json", "JSON", 0, 0, 0, 0, 1, 1
"/home/manodeep/projects/iit_bhilai_2025/llm_security/rep/models/models--Salesforce--blip-image-captioning-base/.no_exist/82a37760796d32b1411fe092ab5d4e227313294b/model.safetensors.index.json", "JSON", 0, 0, 0, 0, 1, 1
"/home/manodeep/projects/iit_bhilai_2025/llm_security/rep/models/models--Salesforce--blip-image-captioning-base/.no_exist/82a37760796d32b1411fe092ab5d4e227313294b/processor_config.json", "JSON", 0, 0, 0, 0, 1, 1
"/home/manodeep/projects/iit_bhilai_2025/llm_security/rep/models/models--Salesforce--blip-image-captioning-base/snapshots/82a37760796d32b1411fe092ab5d4e227313294b/config.json", "JSON", 0, 169, 0, 0, 1, 170
"/home/manodeep/projects/iit_bhilai_2025/llm_security/rep/models/models--Salesforce--blip-image-captioning-base/snapshots/82a37760796d32b1411fe092ab5d4e227313294b/preprocessor_config.json", "JSON", 0, 17, 0, 0, 1, 18
"/home/manodeep/projects/iit_bhilai_2025/llm_security/rep/models/models--Salesforce--blip-image-captioning-base/snapshots/82a37760796d32b1411fe092ab5d4e227313294b/special_tokens_map.json", "JSON", 0, 7, 0, 0, 1, 8
"/home/manodeep/projects/iit_bhilai_2025/llm_security/rep/models/models--Salesforce--blip-image-captioning-base/snapshots/82a37760796d32b1411fe092ab5d4e227313294b/tokenizer.json", "JSON", 0, 30672, 0, 0, 0, 30672
"/home/manodeep/projects/iit_bhilai_2025/llm_security/rep/models/models--Salesforce--blip-image-captioning-base/snapshots/82a37760796d32b1411fe092ab5d4e227313294b/tokenizer_config.json", "JSON", 0, 21, 0, 0, 1, 22
"/home/manodeep/projects/iit_bhilai_2025/llm_security/rep/models/models--Salesforce--blip-image-captioning-large/.no_exist/353689b859fcf0523410b1806dace5fb46ecdf41/adapter_config.json", "JSON", 0, 0, 0, 0, 1, 1
"/home/manodeep/projects/iit_bhilai_2025/llm_security/rep/models/models--Salesforce--blip-image-captioning-large/.no_exist/353689b859fcf0523410b1806dace5fb46ecdf41/added_tokens.json", "JSON", 0, 0, 0, 0, 1, 1
"/home/manodeep/projects/iit_bhilai_2025/llm_security/rep/models/models--Salesforce--blip-image-captioning-large/.no_exist/353689b859fcf0523410b1806dace5fb46ecdf41/chat_template.json", "JSON", 0, 0, 0, 0, 1, 1
"/home/manodeep/projects/iit_bhilai_2025/llm_security/rep/models/models--Salesforce--blip-image-captioning-large/.no_exist/353689b859fcf0523410b1806dace5fb46ecdf41/generation_config.json", "JSON", 0, 0, 0, 0, 1, 1
"/home/manodeep/projects/iit_bhilai_2025/llm_security/rep/models/models--Salesforce--blip-image-captioning-large/.no_exist/353689b859fcf0523410b1806dace5fb46ecdf41/processor_config.json", "JSON", 0, 0, 0, 0, 1, 1
"/home/manodeep/projects/iit_bhilai_2025/llm_security/rep/models/models--Salesforce--blip-image-captioning-large/snapshots/353689b859fcf0523410b1806dace5fb46ecdf41/config.json", "JSON", 0, 170, 0, 0, 1, 171
"/home/manodeep/projects/iit_bhilai_2025/llm_security/rep/models/models--Salesforce--blip-image-captioning-large/snapshots/353689b859fcf0523410b1806dace5fb46ecdf41/preprocessor_config.json", "JSON", 0, 25, 0, 0, 1, 26
"/home/manodeep/projects/iit_bhilai_2025/llm_security/rep/models/models--Salesforce--blip-image-captioning-large/snapshots/353689b859fcf0523410b1806dace5fb46ecdf41/special_tokens_map.json", "JSON", 0, 7, 0, 0, 1, 8
"/home/manodeep/projects/iit_bhilai_2025/llm_security/rep/models/models--Salesforce--blip-image-captioning-large/snapshots/353689b859fcf0523410b1806dace5fb46ecdf41/tokenizer.json", "JSON", 0, 30672, 0, 0, 0, 30672
"/home/manodeep/projects/iit_bhilai_2025/llm_security/rep/models/models--Salesforce--blip-image-captioning-large/snapshots/353689b859fcf0523410b1806dace5fb46ecdf41/tokenizer_config.json", "JSON", 0, 21, 0, 0, 1, 22
"/home/manodeep/projects/iit_bhilai_2025/llm_security/rep/src/pipelines/execution_pipeline/execution_tools/Actuators.py", "Python", 0, 0, 23, 0, 3, 26
"Total", "-", 1, 62673, 115, 7, 47, 62843