"filename", "language", "Markdown", "Python", "JSON", "PostCSS", "HTML", "comment", "blank", "total"
"/home/manodeep/projects/iit_bhilai_2025/llm_security/rep/EXECUTE AGENT.ipynb", "JSON", 0, 0, 1659, 0, 0, 0, 1, 1660
"/home/manodeep/projects/iit_bhilai_2025/llm_security/rep/EXPLOIT AGENT.ipynb", "JSON", 0, 0, 2349, 0, 0, 0, 1, 2350
"/home/manodeep/projects/iit_bhilai_2025/llm_security/rep/README.md", "Markdown", 1, 0, 0, 0, 0, 0, 1, 2
"/home/manodeep/projects/iit_bhilai_2025/llm_security/rep/__init__.py", "Python", 0, 0, 0, 0, 0, 0, 1, 1
"/home/manodeep/projects/iit_bhilai_2025/llm_security/rep/actuators.py", "Python", 0, 0, 0, 0, 0, 1, 4, 5
"/home/manodeep/projects/iit_bhilai_2025/llm_security/rep/data/executable_workflows/Workflow_2.md", "Markdown", 21, 0, 0, 0, 0, 0, 0, 21
"/home/manodeep/projects/iit_bhilai_2025/llm_security/rep/data/extracted_task_workflows/Workflow_0.md", "Markdown", 16, 0, 0, 0, 0, 0, 0, 16
"/home/manodeep/projects/iit_bhilai_2025/llm_security/rep/data/extracted_task_workflows/Workflow_1.md", "Markdown", 8, 0, 0, 0, 0, 0, 0, 8
"/home/manodeep/projects/iit_bhilai_2025/llm_security/rep/data/extracted_task_workflows/Workflow_2.md", "Markdown", 21, 0, 0, 0, 0, 0, 0, 21
"/home/manodeep/projects/iit_bhilai_2025/llm_security/rep/data/extracted_task_workflows/Workflow_3.md", "Markdown", 17, 0, 0, 0, 0, 0, 0, 17
"/home/manodeep/projects/iit_bhilai_2025/llm_security/rep/data/extracted_task_workflows/Workflow_4.md", "Markdown", 11, 0, 0, 0, 0, 0, 0, 11
"/home/manodeep/projects/iit_bhilai_2025/llm_security/rep/html_files/app.py", "Python", 0, 92, 0, 0, 0, 7, 25, 124
"/home/manodeep/projects/iit_bhilai_2025/llm_security/rep/html_files/static/style.css", "PostCSS", 0, 0, 0, 93, 0, 3, 18, 114
"/home/manodeep/projects/iit_bhilai_2025/llm_security/rep/html_files/templates/add_contact.html", "HTML", 0, 0, 0, 0, 14, 0, 7, 21
"/home/manodeep/projects/iit_bhilai_2025/llm_security/rep/html_files/templates/add_ticket.html", "HTML", 0, 0, 0, 0, 16, 0, 7, 23
"/home/manodeep/projects/iit_bhilai_2025/llm_security/rep/html_files/templates/contacts.html", "HTML", 0, 0, 0, 0, 26, 0, 5, 31
"/home/manodeep/projects/iit_bhilai_2025/llm_security/rep/html_files/templates/dashboard.html", "HTML", 0, 0, 0, 0, 10, 0, 3, 13
"/home/manodeep/projects/iit_bhilai_2025/llm_security/rep/html_files/templates/delete_contact.html", "HTML", 0, 0, 0, 0, 10, 0, 4, 14
"/home/manodeep/projects/iit_bhilai_2025/llm_security/rep/html_files/templates/edit_contact.html", "HTML", 0, 0, 0, 0, 14, 0, 7, 21
"/home/manodeep/projects/iit_bhilai_2025/llm_security/rep/html_files/templates/index.html", "HTML", 0, 0, 0, 0, 8, 0, 4, 12
"/home/manodeep/projects/iit_bhilai_2025/llm_security/rep/html_files/templates/layout.html", "HTML", 0, 0, 0, 0, 32, 0, 3, 35
"/home/manodeep/projects/iit_bhilai_2025/llm_security/rep/html_files/templates/search.html", "HTML", 0, 0, 0, 0, 20, 0, 4, 24
"/home/manodeep/projects/iit_bhilai_2025/llm_security/rep/html_files/templates/settings.html", "HTML", 0, 0, 0, 0, 12, 0, 6, 18
"/home/manodeep/projects/iit_bhilai_2025/llm_security/rep/html_files/templates/submit.html", "HTML", 0, 0, 0, 0, 8, 0, 1, 9
"/home/manodeep/projects/iit_bhilai_2025/llm_security/rep/html_files/templates/ticket_detail.html", "HTML", 0, 0, 0, 0, 9, 0, 4, 13
"/home/manodeep/projects/iit_bhilai_2025/llm_security/rep/html_files/templates/tickets.html", "HTML", 0, 0, 0, 0, 19, 0, 4, 23
"/home/manodeep/projects/iit_bhilai_2025/llm_security/rep/html_files/test_app.py", "Python", 0, 92, 0, 0, 0, 7, 25, 124
"/home/manodeep/projects/iit_bhilai_2025/llm_security/rep/llm_bridge.py", "Python", 0, 78, 0, 0, 0, 191, 35, 304
"/home/manodeep/projects/iit_bhilai_2025/llm_security/rep/models/models--Salesforce--blip-image-captioning-base/.no_exist/82a37760796d32b1411fe092ab5d4e227313294b/adapter_config.json", "JSON", 0, 0, 0, 0, 0, 0, 1, 1
"/home/manodeep/projects/iit_bhilai_2025/llm_security/rep/models/models--Salesforce--blip-image-captioning-base/.no_exist/82a37760796d32b1411fe092ab5d4e227313294b/added_tokens.json", "JSON", 0, 0, 0, 0, 0, 0, 1, 1
"/home/manodeep/projects/iit_bhilai_2025/llm_security/rep/models/models--Salesforce--blip-image-captioning-base/.no_exist/82a37760796d32b1411fe092ab5d4e227313294b/chat_template.json", "JSON", 0, 0, 0, 0, 0, 0, 1, 1
"/home/manodeep/projects/iit_bhilai_2025/llm_security/rep/models/models--Salesforce--blip-image-captioning-base/.no_exist/82a37760796d32b1411fe092ab5d4e227313294b/generation_config.json", "JSON", 0, 0, 0, 0, 0, 0, 1, 1
"/home/manodeep/projects/iit_bhilai_2025/llm_security/rep/models/models--Salesforce--blip-image-captioning-base/.no_exist/82a37760796d32b1411fe092ab5d4e227313294b/model.safetensors.index.json", "JSON", 0, 0, 0, 0, 0, 0, 1, 1
"/home/manodeep/projects/iit_bhilai_2025/llm_security/rep/models/models--Salesforce--blip-image-captioning-base/.no_exist/82a37760796d32b1411fe092ab5d4e227313294b/processor_config.json", "JSON", 0, 0, 0, 0, 0, 0, 1, 1
"/home/manodeep/projects/iit_bhilai_2025/llm_security/rep/models/models--Salesforce--blip-image-captioning-base/snapshots/82a37760796d32b1411fe092ab5d4e227313294b/config.json", "JSON", 0, 0, 169, 0, 0, 0, 1, 170
"/home/manodeep/projects/iit_bhilai_2025/llm_security/rep/models/models--Salesforce--blip-image-captioning-base/snapshots/82a37760796d32b1411fe092ab5d4e227313294b/preprocessor_config.json", "JSON", 0, 0, 17, 0, 0, 0, 1, 18
"/home/manodeep/projects/iit_bhilai_2025/llm_security/rep/models/models--Salesforce--blip-image-captioning-base/snapshots/82a37760796d32b1411fe092ab5d4e227313294b/special_tokens_map.json", "JSON", 0, 0, 7, 0, 0, 0, 1, 8
"/home/manodeep/projects/iit_bhilai_2025/llm_security/rep/models/models--Salesforce--blip-image-captioning-base/snapshots/82a37760796d32b1411fe092ab5d4e227313294b/tokenizer.json", "JSON", 0, 0, 30672, 0, 0, 0, 0, 30672
"/home/manodeep/projects/iit_bhilai_2025/llm_security/rep/models/models--Salesforce--blip-image-captioning-base/snapshots/82a37760796d32b1411fe092ab5d4e227313294b/tokenizer_config.json", "JSON", 0, 0, 21, 0, 0, 0, 1, 22
"/home/manodeep/projects/iit_bhilai_2025/llm_security/rep/models/models--Salesforce--blip-image-captioning-large/.no_exist/353689b859fcf0523410b1806dace5fb46ecdf41/adapter_config.json", "JSON", 0, 0, 0, 0, 0, 0, 1, 1
"/home/manodeep/projects/iit_bhilai_2025/llm_security/rep/models/models--Salesforce--blip-image-captioning-large/.no_exist/353689b859fcf0523410b1806dace5fb46ecdf41/added_tokens.json", "JSON", 0, 0, 0, 0, 0, 0, 1, 1
"/home/manodeep/projects/iit_bhilai_2025/llm_security/rep/models/models--Salesforce--blip-image-captioning-large/.no_exist/353689b859fcf0523410b1806dace5fb46ecdf41/chat_template.json", "JSON", 0, 0, 0, 0, 0, 0, 1, 1
"/home/manodeep/projects/iit_bhilai_2025/llm_security/rep/models/models--Salesforce--blip-image-captioning-large/.no_exist/353689b859fcf0523410b1806dace5fb46ecdf41/generation_config.json", "JSON", 0, 0, 0, 0, 0, 0, 1, 1
"/home/manodeep/projects/iit_bhilai_2025/llm_security/rep/models/models--Salesforce--blip-image-captioning-large/.no_exist/353689b859fcf0523410b1806dace5fb46ecdf41/processor_config.json", "JSON", 0, 0, 0, 0, 0, 0, 1, 1
"/home/manodeep/projects/iit_bhilai_2025/llm_security/rep/models/models--Salesforce--blip-image-captioning-large/snapshots/353689b859fcf0523410b1806dace5fb46ecdf41/config.json", "JSON", 0, 0, 170, 0, 0, 0, 1, 171
"/home/manodeep/projects/iit_bhilai_2025/llm_security/rep/models/models--Salesforce--blip-image-captioning-large/snapshots/353689b859fcf0523410b1806dace5fb46ecdf41/preprocessor_config.json", "JSON", 0, 0, 25, 0, 0, 0, 1, 26
"/home/manodeep/projects/iit_bhilai_2025/llm_security/rep/models/models--Salesforce--blip-image-captioning-large/snapshots/353689b859fcf0523410b1806dace5fb46ecdf41/special_tokens_map.json", "JSON", 0, 0, 7, 0, 0, 0, 1, 8
"/home/manodeep/projects/iit_bhilai_2025/llm_security/rep/models/models--Salesforce--blip-image-captioning-large/snapshots/353689b859fcf0523410b1806dace5fb46ecdf41/tokenizer.json", "JSON", 0, 0, 30672, 0, 0, 0, 0, 30672
"/home/manodeep/projects/iit_bhilai_2025/llm_security/rep/models/models--Salesforce--blip-image-captioning-large/snapshots/353689b859fcf0523410b1806dace5fb46ecdf41/tokenizer_config.json", "JSON", 0, 0, 21, 0, 0, 0, 1, 22
"/home/manodeep/projects/iit_bhilai_2025/llm_security/rep/scripts/__init__.py", "Python", 0, 0, 0, 0, 0, 0, 1, 1
"/home/manodeep/projects/iit_bhilai_2025/llm_security/rep/src/__init__.py", "Python", 0, 0, 0, 0, 0, 0, 1, 1
"/home/manodeep/projects/iit_bhilai_2025/llm_security/rep/src/pipelines/__init__.py", "Python", 0, 0, 0, 0, 0, 0, 1, 1
"/home/manodeep/projects/iit_bhilai_2025/llm_security/rep/src/pipelines/execution_pipeline/execution_tools/Actuators.py", "Python", 0, 88, 0, 0, 0, 46, 54, 188
"/home/manodeep/projects/iit_bhilai_2025/llm_security/rep/src/pipelines/execution_pipeline/execution_tools/Brain.py", "Python", 0, 81, 0, 0, 0, 149, 58, 288
"/home/manodeep/projects/iit_bhilai_2025/llm_security/rep/src/pipelines/execution_pipeline/execution_tools/__init__.py", "Python", 0, 0, 0, 0, 0, 0, 1, 1
"/home/manodeep/projects/iit_bhilai_2025/llm_security/rep/src/pipelines/execution_pipeline/task_execution.py", "Python", 0, 188, 0, 0, 0, 28, 167, 383
"/home/manodeep/projects/iit_bhilai_2025/llm_security/rep/src/pipelines/exploit_pipeline/attacker.py", "Python", 0, 0, 0, 0, 0, 0, 1, 1
"/home/manodeep/projects/iit_bhilai_2025/llm_security/rep/src/pipelines/extraction_pipeline/extraction_tools/__init__.py", "Python", 0, 0, 0, 0, 0, 0, 1, 1
"/home/manodeep/projects/iit_bhilai_2025/llm_security/rep/src/pipelines/extraction_pipeline/extraction_tools/llm_bridge.py", "Python", 0, 78, 0, 0, 0, 168, 35, 281
"/home/manodeep/projects/iit_bhilai_2025/llm_security/rep/src/pipelines/extraction_pipeline/task_extraction.py", "Python", 0, 272, 0, 0, 0, 33, 251, 556
"/home/manodeep/projects/iit_bhilai_2025/llm_security/rep/src/pipelines/uitls/__init__.py", "Python", 0, 0, 0, 0, 0, 0, 1, 1
"/home/manodeep/projects/iit_bhilai_2025/llm_security/rep/src/web_scanner.py", "Python", 0, 30, 0, 0, 0, 3, 25, 58
"/home/manodeep/projects/iit_bhilai_2025/llm_security/rep/test.py", "Python", 0, 28, 0, 0, 0, 2, 10, 40
"/home/manodeep/projects/iit_bhilai_2025/llm_security/rep/test_execute_workflow.py", "Python", 0, 150, 0, 0, 0, 310, 121, 581
"/home/manodeep/projects/iit_bhilai_2025/llm_security/rep/test_extract_data.py", "Python", 0, 235, 0, 0, 0, 23, 297, 555
"/home/manodeep/projects/iit_bhilai_2025/llm_security/rep/webapp_plan.md", "Markdown", 51, 0, 0, 0, 0, 0, 16, 67
"Total", "-", 146, 1412, 65789, 93, 198, 971, 1230, 69839